###############################
#     #         # #           #
# ### # ### ##### ### ### # ###
#   #   # #           # # #   #
# # ##### # # ####### # # # # #
# #   #     #     #     # # # #
### ##### ##### ## ###### #####
# # #     #     # # #   #   # #
# # ### ####### # # # ### ### #
#   # #       # #     #     # #
# ### # # # ### ### # ##### # #
# # #   # #     #   # #   # # #
# # ### ### ##### ### # ### # #
#     #   #         # #       #
### ### ##### ### ### ####### #
#   #   # #   # # #     #     #
# ##### # # ### ### # # # # # #
#   #         #     # # # # # #
# # ### ##### # ####### # # # #
# #   # # #           #   # # #
# ### ### ### # ### ######### #
#       #     # #     #       #
# ##### ### ### ####### ##### #
#   #         #         # # # #
# # # ##### ### ### # ### # # #
#   #   #       #   #   #     #
## #### ##### ##### # ### # ###
#     #     #   #   #     #   #
##### # # ### ### ##### ### # #
#       # #     #   #   #   # #
#############################A# 
